XXXXXXXXXXXXXXX
X             X
X             X
X             X
X             X
XX XXXXXXXXXXXX
X         O   X
X             X
X             X
XX XXXXXXX X XX
X             X
XX XXXXXXXXXXXX
XX XXX   XFXXXX
X             X
XX XXXXXXXXXXXX
XX          XXX
