XXXXXXXXXXXXXXX
X            XX
X   XX XXXXXXXX
XX XXX    XXXXX
XX  OX XXXXXXXX
XX XXX XXXXXXXX
XX       XXXXXX
XX XXXXX XXX XX
XX XXXXX     XX
XX XXXXXXX X XX
XX XXXXXXX XXXX
XX XXXXXXX XXXX
XX XXX   F XXXX
XX XXXXXXXXXXXX
XX          XXX
