XXXXXXXXXXXXXXX
X      XXXXXXXX
X   XX XXXXXXXX
XX XXX    XXXXX
XXO  X XXXXXXXX
XX XXX XXXXXXXX
XX X     XXXXXX
XX XXXXX XXX XX
XX XXXXX     XX
XX XXXXXXX X XX
XXXXXXXXXX XXXX
XXXXXXXXXX XXXX
XXXXXX   F XXXX
XXXXXXXXXXXXXXX
XXXXXXXXXXXXXXX
